dd		d
kk		k
q		そ
w		こ
e		し
r		て
t	ょ	
y		つ
u	ん	
i	い	
o	の	
p	り	
@		ち
[	「	
a		は
s		か
d	ら	
f		と
g		た
h		く
j		う
k	も	
l	゛	
;		き
:	れ	
]	」	
z		す
x		け
c	に	
v	な	
b		さ
n	っ	
m	る	
,	、	
.	。	
/	゜	
\	・	
kq	ぁ	
kw		ひ
ke		ほ
kr		ふ
kt	め	
ka	ぃ	
ks	を	
kd	ら	
kf	あ	
kg	よ	
kz	ぅ	
kx		へ
kc		せ
kv	ゅ	
kb	ゃ	
dy	ぬ	
du	え	
di	み	
do	や	
dp	ぇ	
dh	ま	
dj	お	
dk	も	
dl	わ	
d;	ゆ	
dn	む	
dm	ろ	
d,	ね	
d.	ー	
d/	ぉ	
d\	？	
そl	ぞ	
こl	ご	
しl	じ	
てl	で	
つl	づ	
ちl	ぢ	
はl	ば	
かl	が	
とl	ど	
たl	だ	
くl	ぐ	
うl	ヴ	
きl	ぎ	
すl	ず	
けl	げ	
さl	ざ	
ひl	び	
ほl	ぼ	
ふl	ぶ	
へl	べ	
せl	ぜ	
は/	ぱ	
ひ/	ぴ	
ふ/	ぷ	
へ/	ぺ	
ほ/	ぽ	
